NO ./textures/wall_bonus.xpm
SO ./textures/wall_bonus.xpm
WE ./textures/wall_bonus.xpm
EA ./textures/wall_bonus.xpm

F 50,51,52
C 102,103,104

        1111111111111111111111111
        1000000000110000000040401
        1000000000110004000044041
        1011000001110000004000041
        1001000000200000000004041
1111111110110000011100004000404N1
100000000011000001112111111111111
11112111111111011100000010001
11110111111111011101010010001
11000000110101011100000020001
100000000000000020000000100011
10000000000000001101010010001
110000011101010111110111100011
11110111 1110101 101111010001
11111111 1111111 111111111111