NO ./textures/wall_bonus.xpm
SO ./textures/wall_bonus.xpm
WE ./textures/wall_bonus.xpm
EA ./textures/wall_bonus.xpm

F 50,51,52
C 102,103,104

        1111111111111111111111111
        1000000000110000000000001
        1000004000110000000004001
        1011000001110000000000001
        1001000000200000400000001
111111111011000001110000000000001
100004000011000001112111111111111
11112111111111011100000010001
11110111111111011101010010401
11000000110101011100000020001
100000000000000020004000100011
10000400000000001101010010001
11000001110101011111011110N011
11110111 1110101 101111010001
11111111 1111111 111111111111