NO ./random
SO ./random
WE ./random
EA ./random

F 220,100,0
C 225,30,0

         111111111111111111111
         100000011100000001101
         100000011000001010101
111111111100000000000000000001
100000000000000000000000000001
111111100111111111111110001111
      10001           10001
      11111           11111