NO ./textures/wall_north.xpm
SO ./textures/wall_south.xpm
WE ./textures/wall_west.xpm
EA ./textures/wall_east.xpm

F 0,51,0
C 50,150,200


111111111111111111111111111111
100000000000000000000000000001
100000000000000000000000000001
100000000000000000020000000001
100000000000000000000000000001
1000000000W0000000000000000001
100000000000000000000000000001
100000000000000000000000000001
100000000000000000000000000001
100000000000000000000000000001
111111111111111111111111111111